[
    {
        "Layout":[
            [1,1,1,1,1,1,1,1,1,1],
            [1,1,1,1,1,1,1,1,1,1],
            [1,1,1,1,1,1,1,1,1,1],
            [1,1,1,1,1,1,1,1,1,1],
            [1,1,1,1,1,1,1,1,1,1]
        ]
    },
    {
        "Layout":[
            [1,1,1,1,1,1,1,1,1,1],
            [1,0,0,0,1,1,0,0,0,1],
            [1,0,0,0,1,1,0,0,0,1],
            [1,0,0,0,1,1,0,0,0,1],
            [1,1,1,1,1,1,1,1,1,1]
        ]
    },
        {
        "Layout":[
            [1,1,1,1,1,1,1,1,1,1],
            [1,1,1,0,0,1,0,0,1,1],
            [1,0,0,1,1,0,1,1,0,1],
            [1,1,1,0,0,1,0,0,1,1],
            [1,1,1,1,1,1,1,1,1,1]
        ]
    },
    {
        "Layout": [
            [0, 0, 1, 0, 0, 0, 0, 1, 0, 0],
            [0, 0, 1, 0, 0, 0, 0, 1, 0, 0],
            [1, 1, 1, 1, 1, 1, 1, 1, 1, 1],
            [0, 0, 1, 0, 0, 0, 0, 1, 0, 0],
            [0, 0, 1, 0, 0, 0, 0, 1, 0, 0]
        ]
    },
    {
        "Layout": [
            [1, 1, 1, 1, 1, 1, 1, 1, 1, 1],
            [1, 0, 0, 0, 0, 0, 0, 0, 0, 1],
            [1, 0, 1, 1, 1, 1, 1, 1, 0, 1],
            [1, 0, 1, 0, 0, 0, 0, 1, 0, 1],
            [1, 1, 1, 1, 1, 1, 1, 1, 1, 1]
        ]
    },
    {
        "Layout": [
            [1, 1, 1, 1, 1, 1, 1, 1, 1, 1],
            [1, 0, 0, 0, 0, 0, 0, 0, 0, 1],
            [1, 0, 1, 1, 1, 1, 1, 1, 0, 1],
            [1, 0, 1, 0, 0, 0, 0, 1, 0, 1],
            [1, 1, 1, 1, 1, 1, 1, 1, 1, 1]
        ]
    }
]